BBBBBBBBBB
BBBBBBBBBB
BBBBBBBBBB
BBBBBBBBBB
OOXXOOXXOO
OOXXOOXXOO
PPPPPPPPPP
PPPPPPPPPP
PPPPPPPPPP
PPPPPPPPPP
